00000000000000000000
11100000000002000000
00000000000000000000
00000000001111200000
00020000011000000000
00000002010000000011
00000001111100000000
00000001111100002000
02000001111100000000
00000000010000000000
00020000010111100000
00000000011100100000
00000000000000000000
00000000000000010000
11111000000000011111
00000000000000000110
00000000000000000000
00000001111100000000
00000000000100000000
00000000000100000000
